RRRRRRRRRRRRRR
R@...........R
R............R
R..........RRR
R.R.R.R..R.R.R
RRRRRRRRRRRRRR
